SSBWSSBSWW
SWWBBSWWSS
SSBWSSBSSW
BSBBSWWSBS
SSBWSSBWSW
WWSWBBBSBW
SSBWSSBSWs
SSBWSSBSWB
WWSWBSSBBW
SSBWSSBSWB
